{
"NumberOfLevels":2,
  "Levels":[
        {
            "LevelNo": 1,
            "Author":"Cyprian Zawadzki",
            "Version": "0.1",
            "Width": 90,
            "Height": 180,
            "Background": "Colour",
            "Colour":[60,0,40],
            "LevelData":[
                       
                        "#########################################################",
                        "#@   !    7     <            #                       # 8#",
                        "########6##**ó*ó*            #$                $     #  #",
                        "#    **                      #                       #  #",
                        "#   &                        #                          #",  
                        "#########################D####    ##############    ### #",
                        "#                            #                          #",
                        "#                            #                          #",
                        "#             * * * * * * ~  #             $            #",
                        "#              * ` ~ * *     #                          #",
                        "#           ##  ##  ##  ##   #                          #",
                        "#                            #                          #",
                        "##                           ##                         #",
                        "#ó                           ó#                         #",
                        "#                             ########################  #",
                        "#                             #   m       &             #",
                        "#                             ########################D##",
                        "#                             #                         #",
                        "#                             #                         #",
                        "#                             #                         #",
                        "#                             #                         #",  
                        "#######D#######################                         #",
                        "#                   ~         #                         #",
                        "#                             #                         #",
                        "#                   ~         #                         #",
                        "#                   *         #                         #",
                        "#       ....                  #                         #",
                        "#ó      ....      ó     ó    ó#                         #",
                        "##      ....                 ##                         #",
                        "#ó     ó        ....  #      ó#                         #",
                        "#               ....  #       #                         #",
                        "# ....................#.......#                         #",
                        "#  ...................#.......#                         #",
                        "#  ...................#.......#                         #",
                        "#     ^^      X    ^^  $$ M   # + &                     #",
                        "#########################################################",
                        "#>      $    6       d      $#6 7 8#                    #",
                        "#########################################################"


                    ],
            "LevelObjectCorrections":[   ]
        },
        {
            "LevelNo": 2,
            "Author":"Cyprian Zawadzki",
            "Version": "0.1",
            "Width": 59,
            "Height": 36,
            "Background": "Colour",
            "Colour":[0,0,30],
            "LevelData":[
                "###########################################################",
                "#@&D                                                      #",
                "####                                                      #",
                "#                                                         #",
                "#                                                         #",
                "#                                                         #",
                "#                                                         #",
                "#                                                         #",
                "#                                                         #",
                "#                                                         #",
                "#                                                         #",
                "#                                                         #",
                "#                                                         #",
                "#                                                        ##",
                "#                                                         #",
                "#                                                         #",
                "#                                                         #",
                "#                                                         #",
                "#                                                         #",
                "#                                                         #",
                "#                                                         #",
                "#                                                         #",
                "#                                                         #",
                "#                                                         #",
                "###########################################################"

                    ],
            "LevelObjectCorrections":[]
        }

    ]
}

