{
"NumberOfLevels":2,
  "Levels":[
        {
            "LevelNo": 1,
            "Author":"Cyprian Zawadzki",
            "Version": "0.1",
            "Width": 50,
            "Height": 40,
            "Background": "Colour",
            "Colour":[10,10,30],
            "LevelData":[
                        "#################%%%%%%%%%%%%%%%%#################",
                        "# @ #           # t       %     %      #         #",
                        "# # #  #  # *T  #  %%%D%%%%  T  T     7#  ***    #",
                        "#!  # $#        #  %                 & D         #",
                        "###~#######   #####%%d%%D%%%%%%%%%%%D###    X    #",
                        "#  *#     ##D##*                       #         #",
                        "# * * ~  *d     *  &    `` !!!!!!!     #   * *   #",
                        "# 7*     *#      *     <<~~~~~         #    *    #",
                        "##################################################",
                        "#     T     &    m !!!!!!!!            #  t      #",
                        "#                                     X#       $$#",
                        "#    *################################### ####  ##",
                        "#####    ##########                       ###  ###",
                        "##X## ##       ###############################  ##",
                        "##    #######                            ######  #",
                        "##    #     ##########################          ##",
                        "#######     ######################################"


                    ],
            "LevelObjectCorrections":[]
        },
        {
            "LevelNo": 2,
            "Author":"Cyprian Zawadzki",
            "Version": "0.1",
            "Width": 50,
            "Height": 40,
            "Background": "Colour",
            "Colour":[10,10,30],
            "LevelData":[
                        "##################################################",
                        "#   @ !#                                         #",
                        "#  &   D                                         #",
                        "########          M                              #",
                        "#                                                #",
                        "#                   $                            #",
                        "#                                                #",
                        "#                      m                         #",
                        "#                                                #",
                        "#                                               X#",
                        "##################################################"

                    ],
            "LevelObjectCorrections":[]
        }

    ]
}

