{
"NumberOfLevels":2,
  "Levels":[
        {
            "LevelNo": 1,
            "Author":"Cyprian Zawadzki",
            "Version": "0.1",
            "Width": 50,
            "Height": 36,
            "Background": "Colour",
            "Colour":[10,10,30],
            "LevelData":[
                        "#%#%#%#%#%#%#%#%#%#%#%#%#%#%#%#%##################",
                        "# @   tX        # t +& $  %     %      #         #",
                        "# # #  #  # *T  #  %%%D%%%%  T  T     7#  ***    #",
                        "#!  # $#        # +&   #       MmM    & D   MmMlm#",
                        "### #######DDD#####%%d%%D%%%%%%%%%%%D###    X    #",
                        "#   #           ##D#ó       ~      ...ó#         #",
                        "# * * ~  *d  .. *  &    `` !!!!!!!     #   * *   #",
                        "#       ..   ..   ..                             #",
                        "#    !!   .  ..  .                               #", 
                        "#   ~~ó    . .. .                                #",
                        "#          . .. .       k                        #", 
                        "#      <    ....                                ó#",
                        "#  <~~     . .. .                       $$     ###", 
                        "#          . .. .                               ó#",
                        "#         .  ..  .        ó                      #",
                        "#       ..   ..   ..            ....     X#      #",
                        "#            ..                   K              #",
                        "#            *                    *              #",
                        ">                  #ó#                           <",
                        "#          $$      ### ########################  #",
                        "#    !!!            #      v  v       $$         #",
                        "#                  #                             #",
                        "#       >         #                  +           #",
                        "#                #                               #",
                        "#               #ó           $                  ó#",
                        "##################################################"


                    ],
            "LevelObjectCorrections":[   ]
        },
        {
            "LevelNo": 2,
            "Author":"Cyprian Zawadzki",
            "Version": "0.1",
            "Width": 50,
            "Height": 40,
            "Background": "Colour",
            "Colour":[10,10,30],
            "LevelData":[
                        "##################################################",
                        "#   @ !#                                         #",
                        "#  &   D                                         #",
                        "########          M                              #",
                        "#                                                #",
                        "#                   $                            #",
                        "#                                                #",
                        "#                      m                         #",
                        "#                                                #",
                        "#                                               X#",
                        "##################################################"

                    ],
            "LevelObjectCorrections":[]
        }

    ]
}

